#,#,#,#,#,#,#,#,#,#,#,#,#,#,,,,,,,,,,,,,,,,
#,.,.,.,.,.,.,.,.,.,.,.,.,#,,,,,,,,,,,,,,,,
#,.,.,.,.,.,.,.,.,.,.,.,.,#,,,,,,,,,,,,,,,,
#,.,.,.,.,.,.,.,.,.,.,.,.,#,,,,,,,,,,,,,,,,
#,.,.,.,.,.,.,.,.,.,.,.,.,#,,,#,#,#,,#,#,,#,#,#,,#,#,#
#,.,.,.,.,.,.,.,.,.,.,.,#,#,,,,#,,,#,,,#,,,,,#,
#,.,.,.,.,.,.,.,.,.,.,.,#,#,,,,#,,,#,#,,#,#,#,,,#,
#,.,.,.,.,.,.,.,.,.,.,#,#,#,,,,#,,,#,,,,,#,,,#,
#,.,.,.,.,.,.,.,.,.,.,.,.,#,,,,#,,,#,#,,#,#,#,,,#,
#,.,.,.,.,.,.,.,.,.,.,.,.,#,,,,,,,,,,,,,,,,
#,.,.,.,.,.,.,.,.,.,.,.,.,#,,,,,,,,,,,,,,,,
#,.,.,.,.,.,.,.,.,.,.,.,.,#,,,,,,,,,,,,,,,,
#,.,.,.,.,.,#,#,.,.,.,.,.,#,,,,,,,,,,,,,,,,
#,.,.,.,.,.,.,.,.,.,.,.,.,#,,,,,,,,,,,,,,,,
#,.,.,.,.,.,.,.,.,.,.,.,.,#,,,,,,,,,,,,,,,,
#,.,P,#,#,.,.,.,.,.,.,.,.,#,,,,,,,,,,,,,,,,
#,.,.,.,.,.,.,.,.,.,.,.,.,#,,,,,,,,,,,,,,,,
#,.,.,.,.,.,.,.,.,.,.,.,.,#,,,,,,,,,,,,,,,,
#,#,#,#,#,#,#,#,#,#,#,#,#,#,,,,,,,,,,,,,,,,