#,#,#,#,#,#,#,#,#,#,#,#,#,#,#,#,#,#,#,#,#,#,#,#,#,#,#,#,#,#,#,#,#,#,#,#,#,#,#,#,#,#,#,#,#,#,#,#,#,#,#,#,#,#,#,#,#,#,#,#,#,#,#,#,#,#,#,#,#,#,#,#,#,#,#,#,#,#,#,#,#,#,#,#,#,#,#,#,#,#,#,#,#,#
#,.,.,.,.,.,.,.,.,.,.,.,.,.,V,.,.,.,V,.,.,.,V,.,.,.,.,.,.,.,.,.,.,.,.,.,.,.,.,#,#,.,.,.,.,.,.,.,.,.,.,.,.,.,.,.,.,.,V,.,.,V,.,V,#,V,.,.,.,.,V,.,.,.,.,.,.,.,#,#,#,.,V,.,#,#,.V,.,.,.,.,.,.,#
#,.,.,.,.,.,.,.,.,.,.,.,.,.,V,.,.,.,V,.,.,.,V,.,.,.,.,.,.,.,.,.,.,.,.,.,.,.,.,#,#,.,.,.,.,.,.,.,.,.,.,.,.,JF,.,.,.,.,V,.,.,V,.,V,#,V,.,.,.,.,V,.,.,.,.,JF,.,.,W4,#,W5,.,V,.,#,#,V,.,.,.,.,.,.,#
#,.,.,.,.,.,.,.,.,.,.,.,.,.,V,.,.,.,V,.,.,.,V,.,.,.,.,.,.,.,.,.,.,.,.,.,.,.,.,#,#,.,.,.,.,#,#,#,#,#,#,#,#,#,#,#,.,.,V,.,.,V,.,V,#,V,.,.,.,.,V,.,.,.,.,#,#,#,#,#,#,.,V,.,#,#,V,.,.,.,.,.,.,#
#,.,.,.,.,.,.,.,.,.,.,.,.,.,V,.,.,.,V,.,.,.,V,.,.,.,.,.,.,.,.,.,.,.,.,.,.,.,.,#,#,.,.,$,#,#,.,.,.,.,.,.,.,.,#,#,.,.,V,.,.,V,.,V,#,V,.,.,.,.,V,.,.,.,.,#,#,#,#,#,#,.,V,.,#,#,V,.,YD,W10,MNM,.,.,#
#,.,.,.,.,.,.,.,.,.,.,.,.,.,V,.,.,.,V,.,.,.,V,.,.,.,.,JF,.,.,.,.,.,.,.,.,.,.,.,#,#,.,#,#,#,.,.,.,.,.,.,.,.,JF,#,#,.,.,V,.,.,.,.,V,#,V,.,.,.,.,V,.,.,.,.,.,.,.,#,#,#,.,V,.,#,#,V,.,#,#,#,#,.,#
#,.,.,.,.,.,.,.,.,.,.,.,.,.,V,.,.,.,V,.,.,.,V,.,.,#,#,#,#,.,.,.,.,.,.,.,.,.,.,#,#,.,.,.,.,.,.,.,.,.,.,.,.,#,#,#,.,.,V,.,.,.,.,V,#,V,.,.,.,.,V,.,.,#,#,.,.,.,#,#,#,.,V,.,#,#,V,#,#,#,#,#,.,#
#,.,.,.,.,.,.,.,.,.,.,.,.,.,V,.,.,.,V,.,.,.,.,.,.,#,#,#,#,.,.,.,.,.,.,.,.,.,.,#,#,.,.,.,.,.,.,.,.,.,.,.,.,#,#,#,.,.,V,.,.,.,.,V,#,V,.,.,.,.,V,.,.,V,.,.,.,.,#,#,#,.,V,.,#,#,V,#,#,#,#,#,.,#
#,.,.,.,.,.,.,.,.,.,.,.,.,.,V,.,.,.,V,.,.,.,.,.,.,.,.,.,.,.,.,.,.,.,.,.,.,.,.,#,#,.,A3,A3,.,.,.,.,.,.,.,.,.,#,#,#,.,.,V,.,.,.,.,V,.,V,.,.,.,.,V,.,.,V,.,.,.,.,#,#,#,.,V,.,.,a5,V,#,#,#,#,#,.,#
#,.,.,.,.,.,.,.,.,.,.,.,.,.,V,.,.,.,V,.,.,.,.,.,.,.,.,.,.,.,.,.,.,JF,.,.,.,.,.,#,#,JF,.,.,.,.,.,.,.,.,.,.,.,W3,#,#,.,.,V,.,.,.,.,V,.,V,.,.,.,.,V,.,.,V,.,.,.,.,#,#,#,.,V,.,.,a5,V,#,#,#,#,#,.,#
#,.,.,.,.,.,.,.,.,.,.,.,.,.,V,.,.,.,V,.,.,.,.,.,.,.,.,.,.,.,.,.,#,#,#,#,.,.,.,#,#,#,.,.,.,.,.,.,.,.,.,.,.,#,#,#,.,.,.,.,.,.,.,V,.,V,.,.,.,.,V,.,.,V,.,.,.,JF,#,#,#,.,V,.,.,a5,#,#,#,#,#,#,.,#
#,.,.,.,.,.,.,.,.,.,.,.,.,.,V,.,.,.,.,.,.,.,.,.,.,.,.,.,.,.,.,.,#,#,#,#,.,.,.,#,#,#,.,A3,A3,.,.,.,.,.,.,.,.,#,#,#,.,.,.,.,.,.,.,V,.,V,.,.,.,.,V,.,.,V,.,.,.,#,#,#,#,.,V,.,.,#,#,#,#,#,#,#,.,#
#,.,.,.,.,.,.,.,.,.,.,.,.,.,V,.,.,.,.,.,.,.,.,.,.,.,.,.,.,.,.,.,.,.,.,.,.,.,.,#,#,V,.,.,.,.,.,.,.,.,.,.,.,#,#,#,.,.,.,.,.,.,.,.,.,V,.,.,.,.,V,.,.,V,.,.,.,#,#,#,#,.,V,.,.,#,#,#,#,#,#,#,.,#
#,.,.,.,.,.,.,.,.,.,.,.,.,.,V,.,.,.,.,.,.,.,.,.,.,.,.,.,.,.,.,.,.,.,.,.,.,.,.,#,#,V,.,.,.,.,.,.,.,.,.,.,.,#,#,#,.,.,.,.,.,.,.,.,.,V,.,.,.,.,V,.,.,V,.,.,.,.,#,#,#,.,.,.,.,#,#,#,#,#,#,#,.,#
#,.,.,.,.,.,.,.,.,.,.,.,.,.,V,.,.,.,.,.,.,.,.,.,.,.,.,.,.,.,.,.,.,.,.,.,.,.,.,#,#,V,.,.,.,.,.,.,.,.,.,.,+,#,#,#,Y,Y,Y,Y,Y,Y,Y,Y,Y,Y,Y,Y,Y,.,.,.,.,V,.,.,.,.,#,#,#,.,.,.,.,#,#,#,#,#,#,#,.,#
#,.,.,.,.,.,.,.,.,.,.,.,.,.,V,.,.,.,.,.,.,.,.,.,.,.,.,.,.,.,.,.,.,.,.,.,.,.,.,#,#,V,#,#,#,#,#,#,#,#,#,#,#,#,#,#,#,#,#,#,#,#,#,#,#,#,#,#,Y,.,.,.,.,V,.,.,.,.,#,#,#,.,.,.,JF,#,#,#,#,#,#,#,.,#
#,.,.,.,.,.,.,.,.,.,.,.,.,.,V,.,.,.,.,.,.,.,.,.,.,.,.,.,.,.,.,.,.,.,.,.,.,.,.,#,#,V,#,#,#,#,#,#,#,#,#,#,#,#,#,#,#,#,#,#,#,#,#,#,#,#,#,#,Y,.,.,.,.,V,.,.,.,.,#,#,#,.,.,.,#,#,#,#,#,#,#,#,.,#
#,.,.,.,.,.,.,.,.,.,.,.,.,.,V,.,.,.,.,.,.,.,.,.,.,.,.,.,.,.,.,.,.,.,.,.,.,.,.,#,#,V,.,.,.,.,.,.,.,.,.,.,.,.,.,.,.,.,.,.,.,.,.,.,.,.,#,#,Y,.,.,.,.,.,.,.,.,.,#,#,#,.,.,.,.,#,#,#,#,#,#,#,.,#
#,.,.,.,.,.,.,.,.,.,.,.,.,.,V,.,.,.,.,Y,Y,Y,Y,.,.,.,.,.,.,.,.,.,.,.,.,.,.,.,.,#,#,V,.,.,.,.,.,.,.,.,.,.,.,JF,.,.,.,.,.,.,.,.,.,.,.,.,#,#,Y,.,.,.,.,.,.,.,.,.,#,#,#,.,.,.,.,#,#,#,#,#,#,#,.,#
#,.,.,.,.,.,.,.,.,.,.,.,.,.,V,,a1,a1,a1,#,#,#,#,.,.,.,.,.,.,.,.,.,.,.,.,.,.,.,.,#,#,V,.,.,.,.,.,.,.,.,.,#,#,#,.,.,.,.,.,.,.,.,.,.,JF,.,#,#,Y,.,.,.,.,.,.,.,.,.,#,#,#,JF,.,.,.,#,#,#,#,#,#,#,.,#
#,.,.,.,.,.,.,.,.,.,.,.,.,.,V,.,.,.,.,#,#,#,#,.,.,.,.,.,.,.,.,.,.,.,.,.,.,.,.,#,#,V,.,.,.,.,JF,.,.,.,.,.,.,.,.,.,.,.,.,.,.,.,.,.,#,#,#,#,Y,Y,Y,Y,Y,Y,a4,a4,a4,a4,#,#,#,#,.,.,.,#,#,#,#,#,#,#,.,#
#,.,.,.,.,.,.,.,.,.,.,.,.,.,.,.,.,.,.,#,#,#,#,.,.,.,.,.,.,.,.,.,.,.,.,.,.,.,.,#,#,V,.,.,#,#,#,.,.,.,.,.,.,.,.,.,.,.,.,.,.,.,.,.,.,.,#,#,#,#,#,#,#,#,a4,a4,a4,a4,#,#,#,#,.,.,.,#,#,#,#,#,#,#,.,#
#,.,.,.,.,.,.,.,.,.,.,.,.,.,.,.,.,.,.,#,#,#,#,.,.,.,.,.,.,.,.,.,.,.,.,.,.,.,.,#,#,V,.,.,.,.,.,.,.,.,.,.,.,.,.,.,.,.,.,.,.,.,.,.,.,.,#,#,#,#,#,#,#,#,.,.,.,.,.,.,.,.,.,.,.,#,#,#,#,#,#,#,.,#
#,.,.,.,.,.,.,.,.,.,.,.,.,.,.,.,.,.,.,W1,#,#,#,.,.,.,.,.,.,.,.,.,.,.,.,.,.,.,.,#,#,V,.,.,.,.,.,.,.,.,.,.,.,.,.,.,JF,.,.,.,.,.,.,.,.,.,.,.,V,.,.,#,#,#,.,.,.,.,.,.,.,.,.,.,.,#,#,#,#,#,#,#,.,#
#,.,.,.,.,.,.,.,.,.,.,.,.,.,,,.,.,.,#,#,#,#,.,.,.,.,.,.,.,.,.,.,.,.,.,.,.,.,#,#,V,.,.,.,.,.,.,.,.,.,.,.,.,#,#,#,.,.,.,.,.,.,.,.,.,.,.,V,.,.,#,#,#,.,.,.,.,.,.,.,.,.,JF,.,#,#,#,#,#,#,#,.,#
#,.,.,.,.,.,.,.,.,.,.,.,.,.,A1,A1,.,.,.,#,#,#,#,.,.,.,.,.,.,.,.,.,.,.,.,.,.,.,.,#,#,.,.,.,.,.,.,.,.,.,.,.,.,.,.,.,.,.,.,.,.,.,.,.,.,.,.,.,V,.,.,#,#,#,.,.,.,.,.,.,.,.,.,#,#,#,#,#,#,#,#,#,.,#
#,.,.,.,.,P,.,.,.,.,.,.,.,.,.,.,.,.,.,#,#,#,#,.,.,.,.,.,.,.,.,.,.,.,.,.,.,.,.,#,#,.,.,.,.,.,.,.,.,.,.,.,.,.,.,.,.,.,.,.,.,.,.,.,.,.,.,.,V,.,.,#,#,#,.,.,.,.,.,.,.,.,.,.,.,#,#,#,#,#,#,#,.,#
#,.,.,.,.,Z,.,.,.,.,.,.,.,.,.,.,.,.,.,#,#,#,#,.,.,.,.,.,.,.,.,.,.,.,.,.,.,.,.,#,#,.,.,.,.,.,.,.,.,.,.,.,.,.,.,.,.,.,.,.,.,.,.,.,.,.,.,.,V,.,.,#,#,#,.,.,.,.,.,.,.,.,.,.,.,#,#,#,#,#,#,#,.,#
#,a10,a10,a10,a10,.,,.,.,.,.,.,.,.,.,.,.,.,.,#,#,#,#,Y,Y,Y,Y,Y,Y,Y,Y,Y,Y,Y,Y,Y,.,.,.,#,#,#,#,#,#,#,#,#,#,#,#,#,#,#,#,#,#,#,#,#,#,#,#,#,#,#,#,#,V,.,T,#,#,#,.,.,.,.,.,.,.,.,.,.,.,#,#,#,#,#,#,#,.,#
#,D1,D1,D1,#,#,#,#,#,#,#,#,#,#,#,#,#,#,#,#,#,#,#,#,#,#,#,#,#,#,#,#,#,#,#,#,.,.,.,#,#,#,#,#,#,#,#,#,#,#,#,#,#,#,#,#,#,#,#,#,#,#,#,#,#,#,#,#,V,#,#,#,#,#,#,#,#,#,#,#,#,#,#,#,#,#,#,#,#,#,#,#,.,#
#,.,.,.,#,#,#,#,#,#,#,#,#,#,#,#,#,#,#,#,#,#,#,#,#,#,#,#,#,#,#,#,#,#,#,#,.,.,.,#,#,.,.,.,.,.,.,.,.,.,.,.,.,.,.,.,.,.,.,.,.,.,.,.,V,#,#,#,V,#,#,#,#,#,#,#,#,#,#,#,#,#,#,#,#,#,#,#,#,#,#,#,.,#
#,#,#,.,#,#,#,#,#,#,#,#,#,#,#,#,#,#,#,#,#,#,#,#,#,#,#,#,#,#,#,#,#,#,#,#,.,.,.,#,#,W2,.,.,.,.,.,.,.,.,.,.,.,.,.,.,.,.,.,.,.,.,.,.,V,#,#,#,V,#,#,#,#,#,#,#,#,#,#,#,#,#,#,#,#,#,#,#,#,#,#,#,.,#
#,.,V,.,#,#,#,#,#,#,#,#,#,#,#,#,#,#,#,#,#,#,#,#,#,#,#,#,#,#,#,#,#,#,#,#,.,.,.,#,#,.,.,.,.,.,.,.,.,.,.,.,.,.,.,.,.,.,.,.,.,.,.,.,V,#,#,#,V,#,#,#,#,#,#,#,#,#,#,#,#,#,#,#,#,#,#,#,#,#,#,#,.,#
#,.,V,.,#,#,#,#,#,#,#,#,#,#,#,#,#,#,#,#,#,#,#,#,#,#,#,#,#,#,#,#,#,#,#,#,.,.,.,#,#,.,.,.,.,.,.,.,.,.,.,.,#,#,#,#,#,#,#,#,#,#,#,.,V,#,#,#,V,#,#,#,#,#,#,#,#,#,#,#,#,#,#,#,#,#,#,#,#,#,#,#,.,#
#,.,V,.,#,#,#,#,#,#,#,#,#,#,#,#,#,#,#,#,#,#,#,#,#,#,#,#,#,#,#,#,#,#,#,#,.,.,.,#,#,.,.,.,.,.,.,.,.,.,.,.,#,V,.,.,.,.,V,.,.,.,V,.,V,#,#,#,V,#,#,#,#,#,#,#,#,#,#,#,#,#,#,#,#,#,#,#,#,#,#,#,.,#
#,.,V,.,#,#,#,#,#,#,#,#,#,#,#,#,#,#,#,#,#,#,#,#,#,#,#,#,#,#,#,#,#,#,#,#,.,.,.,#,#,.,.,.,.,.,.,.,.,.,#,#,#,V,.,.,.,.,V,.,.,.,V,.,V,#,#,#,V,#,#,#,#,#,#,#,#,#,#,#,#,#,#,#,#,#,#,#,#,#,#,#,.,#
#,.,V,#,#,#,#,#,#,#,#,#,#,#,#,#,#,#,#,#,#,#,#,#,#,#,#,#,#,#,#,#,#,#,#,#,.,.,.,#,#,.,.,.,.,.,.,.,.,.,#,#,#,V,.,.,.,.,V,.,.,.,V,.,V,#,#,#,V,#,#,#,#,#,#,#,#,#,#,#,#,#,#,#,#,#,#,#,#,#,#,#,.,#
#,.,V,.,#,#,#,#,#,#,#,#,#,#,#,#,#,#,#,#,#,#,#,#,#,#,#,#,#,#,#,#,#,#,#,#,.,.,.,#,#,T,.,.,.,JF,.,.,.,.,#,#,#,V,.,.,.,.,V,.,.,.,V,.,V,#,#,#,V,#,#,#,#,#,#,#,#,#,#,#,#,#,#,#,#,#,#,#,#,#,#,#,.,#
#,.,V,.,#,#,#,#,#,#,#,#,#,#,#,#,#,#,#,#,#,#,#,#,#,#,#,#,#,#,#,#,#,#,#,#,.,.,.,#,#,#,#,#,#,#,#,#,#,#,#,#,#,V,.,.,.,.,V,.,.,.,V,.,.,#,#,#,V,#,#,#,#,#,#,#,#,#,#,#,#,#,#,#,#,#,#,#,#,#,#,#,.,#
#,.,V,.,#,#,#,#,#,#,#,#,#,#,#,#,#,#,#,#,#,#,#,#,#,#,#,#,#,#,#,#,#,#,#,#,.,.,.,#,#,#,#,#,#,#,#,#,#,#,#,.,.,V,.,.,.,.,V,.,.,.,V,.,.,#,#,#,V,#,#,#,#,#,#,#,#,#,#,#,#,#,#,#,#,#,#,#,#,#,#,#,.,#
#,.,V,.,#,#,#,#,#,#,#,#,#,#,#,#,#,#,#,#,#,#,#,#,#,#,#,#,#,#,#,#,#,#,#,#,.,.,.,#,#,#,#,#,#,#,#,#,#,#,#,.,.,V,.,.,.,.,V,.,.,.,V,.,.,#,#,#,V,#,#,#,#,#,#,#,#,#,#,#,#,#,#,#,#,#,#,#,#,#,#,#,.,#
#,.,V,.,#,#,#,#,#,#,#,#,#,#,#,#,#,#,#,#,#,#,#,#,#,#,#,#,#,#,#,#,#,#,#,#,.,.,.,#,#,.,V,.,.,.,.,.,.,.,.,.,.,V,.,.,.,.,V,.,.,.,V,.,.,Y,#,#,V,#,#,#,#,#,#,#,#,#,#,#,#,#,#,#,#,#,#,#,#,#,#,#,.,#
#,.,V,.,#,#,#,#,#,#,#,#,#,#,#,#,#,#,#,#,#,#,#,#,#,#,#,#,#,#,#,#,#,#,#,#,.,.,.,#,#,.,V,.,.,.,.,.,.,.,.,.,.,.,.,.,.,.,.,.,.,.,.,.,.,Y,#,#,V,#,#,#,#,#,#,#,#,#,#,#,#,#,#,#,#,#,#,#,#,#,#,#,.,#
#,.,V,.,#,#,#,#,#,#,#,#,#,#,#,#,#,#,#,#,#,#,#,#,#,#,#,#,#,#,#,#,#,#,#,#,.,.,.,#,#,.,V,.,.,.,.,.,.,.,.,.,.,.,.,.,.,.,.,.,.,.,.,.,.,Y,#,#,V,#,#,#,#,#,#,#,#,#,#,#,#,#,#,#,#,#,#,#,#,#,#,#,.,#
#,.,V,.,#,#,#,#,#,#,#,#,#,#,#,#,#,#,#,#,#,#,#,#,#,#,#,#,#,#,#,#,#,#,#,#,.,.,.,#,#,.,V,#,#,#,#,#,#,#,#,#,#,Y,Y,Y,Y,Y,Y,Y,Y,Y,Y,Y,Y,#,#,#,V,#,#,#,#,#,#,#,#,#,#,#,#,#,#,#,#,#,#,#,#,#,#,#,.,#
#,.,V,.,#,#,#,#,#,#,#,#,#,#,#,#,#,#,#,#,#,#,#,#,#,#,#,#,#,#,#,#,#,#,#,#,.,.,.,#,#,.,V,#,#,#,#,#,#,#,#,#,#,#,#,#,#,#,#,#,#,#,#,#,#,#,#,#,V,#,#,#,#,#,#,#,#,#,#,#,#,#,#,#,#,#,#,#,#,#,#,#,.,#
#,.,V,.,#,#,#,#,#,#,#,#,#,#,#,#,#,#,#,#,#,#,#,#,#,#,#,#,#,#,#,#,#,#,#,#,.,.,.,#,#,.,V,#,#,#,#,#,#,#,#,#,#,#,#,#,#,#,#,#,#,#,#,#,#,#,#,#,V,#,#,#,#,#,#,#,#,#,#,#,#,#,#,#,#,#,#,#,#,#,#,#,.,#
#,.,V,.,#,#,#,#,#,#,#,#,#,#,#,#,#,#,#,#,#,#,#,#,#,#,#,#,#,#,#,#,#,#,#,#,.,.,.,#,#,.,V,#,#,#,#,#,#,#,#,#,#,#,#,#,#,#,#,#,#,#,#,#,#,#,#,#,V,#,#,#,#,#,#,#,#,#,#,#,#,#,#,#,#,#,#,#,#,#,#,#,.,#
#,.,V,.,#,#,#,#,#,#,#,#,#,#,#,#,#,#,#,#,#,#,#,#,#,#,#,#,#,#,#,#,#,#,#,#,.,.,.,#,#,.,V,#,#,#,#,#,#,#,#,#,#,#,#,#,#,#,#,#,#,#,#,#,#,#,#,#,V,#,#,#,#,#,#,#,#,#,#,#,#,#,#,#,#,#,#,#,#,#,#,#,.,#
#,.,V,.,#,#,#,#,#,#,#,#,#,#,#,#,#,#,#,#,#,#,#,#,#,#,#,#,#,#,#,#,#,#,#,#,.,.,.,#,#,.,V,#,#,#,#,#,#,#,#,#,#,#,#,#,#,#,#,#,#,#,#,#,#,#,#,#,V,#,#,#,#,#,#,#,#,#,#,#,#,#,#,#,#,#,#,#,#,#,#,#,.,#
#,.,V,.,#,#,#,#,#,#,#,#,#,#,#,#,#,#,#,#,#,#,#,#,#,#,#,#,#,#,#,#,#,#,#,#,.,.,.,#,#,.,V,#,#,#,#,#,#,#,#,#,#,#,#,#,#,#,#,#,#,#,#,#,#,#,#,#,V,#,#,#,#,#,#,#,#,#,#,#,#,#,#,#,#,#,#,#,#,#,#,#,.,#
#,.,V,.,#,#,#,#,#,#,#,#,#,#,#,#,#,#,#,#,#,#,#,#,#,#,#,#,#,#,#,#,#,#,#,#,.,.,.,#,#,.,V,#,#,#,#,#,#,#,#,#,#,#,#,#,#,#,#,#,#,#,#,#,#,#,#,#,V,#,#,#,#,#,#,#,#,#,#,#,#,#,#,#,#,#,#,#,#,#,#,#,.,#
#,.,V,.,#,#,#,#,#,#,#,#,#,#,#,#,#,#,#,#,#,#,#,#,#,#,#,#,#,#,#,#,#,#,#,#,.,.,.,#,#,.,.,.,.,.,.,.,.,.,.,.,.,.,.,.,.,.,.,.,.,.,V,#,#,#,#,#,V,#,#,#,#,#,#,#,#,#,#,#,#,#,#,#,#,#,#,#,#,#,#,#,.,#
#,.,V,.,#,#,#,#,#,#,#,#,#,#,#,#,#,#,#,#,#,#,#,#,#,#,#,#,#,#,#,#,#,#,#,#,.,.,.,#,#,.,.,.,.,.,.,.,.,.,.,.,.,.,.,.,.,.,.,.,.,.,V,#,#,#,#,#,V,#,#,#,#,#,#,#,#,#,#,#,#,#,#,#,#,#,#,#,#,#,#,#,.,#
#,.,V,.,#,#,#,#,#,#,#,#,#,#,#,#,#,#,#,#,#,#,#,#,#,#,#,#,#,#,#,#,#,#,#,#,.,.,.,#,#,.,.,.,.,.,.,.,.,.,.,.,.,.,.,.,.,.,.,.,.,.,V,#,#,#,#,#,V,#,#,#,#,#,#,#,#,#,#,#,#,#,#,#,#,#,#,#,#,#,#,#,.,#
#,.,V,.,#,#,#,#,#,#,#,#,#,#,#,#,#,#,#,#,#,#,#,#,#,#,#,#,#,#,#,#,#,#,#,#,.,.,.,#,#,#,#,#,#,#,#,#,#,#,#,#,#,#,#,#,#,#,#,#,#,#,V,#,#,#,#,#,V,#,#,#,#,#,#,#,#,#,#,#,#,#,#,#,#,#,#,#,#,#,#,#,.,#
#,.,V,.,#,#,#,#,#,#,#,#,#,#,#,#,#,#,#,#,#,#,#,#,#,#,#,#,#,#,#,#,#,#,#,#,.,.,.,#,#,#,#,#,#,#,#,#,#,#,#,#,#,#,#,#,#,#,#,#,#,#,V,#,#,#,#,#,V,#,#,#,#,#,#,#,#,#,#,#,#,#,#,#,#,#,#,#,#,#,#,#,.,#
#,.,V,.,#,#,#,#,#,#,#,#,#,#,#,#,#,#,#,#,#,#,#,#,#,#,#,#,#,#,#,#,#,#,#,#,.,.,.,#,#,#,#,#,#,#,#,#,#,#,#,#,#,#,#,#,#,#,#,#,#,#,V,#,#,#,#,#,V,#,#,#,#,#,#,#,#,#,#,#,#,#,#,#,#,#,#,#,#,#,#,#,.,#
#,.,V,.,#,#,#,#,#,#,#,#,#,#,#,#,#,#,#,#,#,#,#,#,#,#,#,#,#,#,#,#,#,#,#,#,.,.,.,#,#,.,.,.,.,.,.,.,.,.,.,.,.,.,#,#,#,#,#,#,#,#,V,#,#,#,#,#,V,#,#,#,#,#,#,#,#,#,#,#,#,#,#,#,#,#,#,#,#,#,#,#,.,#
#,.,V,.,#,#,#,#,#,#,#,#,#,#,#,#,#,#,#,#,#,#,#,#,#,#,#,#,#,#,#,#,#,#,#,#,.,.,.,#,#,W1,.,.,.,JF,.,.,.,.,.,.,.,.,#,#,#,#,#,#,#,#,V,#,#,#,#,#,V,#,#,#,#,#,#,#,#,#,#,#,#,#,#,#,#,#,#,#,#,#,#,#,.,#
#,.,V,.,#,#,#,#,#,#,#,#,#,#,#,#,#,#,#,#,#,#,#,#,#,#,#,#,#,#,#,#,#,#,#,#,.,.,.,#,#,#,#,#,#,#,#,#,#,#,#,#,.,.,#,#,#,#,#,#,#,#,V,#,#,#,#,#,V,#,#,#,#,#,#,#,#,#,#,#,#,#,#,#,#,#,#,#,#,#,#,#,.,#
#,.,V,.,#,#,#,#,#,#,#,#,#,#,#,#,#,#,#,#,#,#,#,#,#,#,#,#,#,#,#,#,#,#,#,#,.,.,.,#,#,#,#,#,#,#,#,#,#,#,#,#,.,.,#,#,#,#,#,#,#,#,V,#,#,#,#,#,V,#,#,#,#,#,#,#,#,#,#,#,#,#,#,#,#,#,#,#,#,#,#,#,.,#
#,.,V,.,#,#,#,#,#,#,#,#,#,#,#,#,#,#,#,#,#,#,#,#,#,#,#,#,#,#,#,#,#,#,#,#,.,.,.,.,.,.,.,.,.,.,.,.,.,.,.,.,.,.,.,A1,A1,.,.,.,.,.,.,a2,a2,.,.,.,.,#,#,#,#,#,#,#,#,#,#,#,#,#,#,#,#,#,#,#,#,#,#,#,.,#
#,.,V,.,#,#,#,#,#,#,#,#,#,#,#,#,#,#,#,#,#,#,#,#,#,#,#,#,#,#,#,#,#,#,#,#,.,.,.,.,.,.,.,.,.,.,.,.,.,.,.,.,.,.,.,A1,A1,.,.,.,.,.,.,a2,a2,.,.,.,.,#,#,#,#,#,#,#,#,#,#,#,#,#,#,#,#,#,#,#,#,#,#,#,.,#
#,.,V,.,#,#,#,#,#,#,#,#,#,#,#,#,#,#,#,#,#,#,#,#,#,#,#,#,#,#,#,#,#,#,#,#,#,#,#,#,#,#,#,#,#,#,#,#,#,#,#,#,#,#,#,#,#,#,#,#,#,#,#,#,#,#,#,#,#,#,#,#,#,#,#,#,#,#,#,#,#,#,#,#,#,#,#,#,#,#,#,#,.,#
#,.,V,.,#,#,#,#,#,#,#,#,#,#,#,#,#,#,#,#,#,#,#,#,#,#,#,#,#,#,#,#,#,#,#,#,#,#,#,#,#,#,#,#,#,#,#,#,#,#,#,#,#,#,#,#,#,#,#,#,#,#,#,#,#,#,#,#,#,#,#,#,#,#,#,#,#,#,#,#,#,#,#,#,#,#,#,#,#,#,#,#,.,#
#,.,V,.,#,#,#,#,#,#,#,#,#,#,#,#,#,#,#,#,#,#,#,#,#,#,#,#,#,#,#,#,#,#,#,#,#,#,#,#,#,#,#,#,#,#,#,#,#,#,#,#,#,#,#,#,#,#,#,#,#,#,#,#,#,#,#,#,#,#,#,#,#,#,#,#,#,#,#,#,#,#,#,#,#,#,#,#,#,#,#,#,.,#
#,.,V,.,#,#,#,#,#,#,#,#,#,#,#,#,#,#,#,#,#,#,#,#,#,#,#,#,#,#,#,#,#,#,#,#,#,#,#,#,#,#,#,#,#,#,#,#,#,#,#,#,#,#,#,#,#,#,#,#,#,#,#,#,#,#,#,#,#,#,#,#,#,#,#,#,#,#,#,#,#,#,#,#,#,#,#,#,#,#,#,#,.,#
#,.,V,.,#,#,#,#,#,#,#,#,#,#,#,#,#,#,#,#,#,#,#,#,#,#,#,#,#,#,#,#,#,#,#,#,#,#,#,#,#,#,#,#,#,#,#,#,#,#,#,#,#,#,#,#,#,#,#,#,#,#,#,#,#,#,#,#,#,#,#,#,#,#,#,#,#,#,#,#,#,#,#,#,#,#,#,#,#,#,#,#,.,#
#,.,V,.,#,#,#,#,#,#,#,#,#,#,#,#,#,#,#,#,#,#,#,#,#,#,#,#,#,#,#,#,#,#,#,#,#,#,#,#,#,#,#,#,#,#,#,#,#,#,#,#,#,#,#,#,#,#,#,#,#,#,#,#,#,#,#,#,#,#,#,#,#,#,#,#,#,#,#,#,#,#,#,#,#,#,#,#,#,#,#,#,.,#
#,.,V,.,#,#,#,#,#,#,#,#,#,#,#,#,#,#,#,#,#,#,#,#,#,#,#,#,#,#,#,#,#,#,#,#,#,#,#,#,#,#,#,#,#,#,#,#,#,#,#,#,#,#,#,#,#,#,#,#,#,#,#,#,#,#,#,#,#,#,#,#,#,#,#,#,#,#,#,#,#,#,#,#,#,#,#,#,#,#,#,#,.,#
#,.,V,.,#,#,#,#,#,#,#,#,#,#,#,#,#,#,#,#,#,#,#,#,#,#,#,#,#,#,#,#,#,#,#,#,#,#,#,#,#,#,#,#,#,#,#,#,#,#,#,#,#,#,#,#,#,#,#,#,#,#,#,#,#,#,#,#,#,#,#,#,#,#,#,#,#,#,#,#,#,#,#,#,#,#,#,#,#,#,#,#,.,#
#,.,V,.,#,#,#,#,#,#,#,#,#,#,#,#,#,#,#,#,#,#,#,#,#,#,#,#,#,#,#,#,#,#,#,#,#,#,#,#,#,#,#,#,#,#,#,#,#,#,#,#,#,#,#,#,#,#,#,#,#,#,#,#,#,#,#,#,#,#,#,#,#,#,#,#,#,#,#,#,#,#,#,#,#,#,#,#,#,#,#,#,.,#
#,.,V,.,#,#,#,#,#,#,#,#,#,#,#,#,#,#,#,#,#,#,#,#,#,#,#,#,#,#,#,#,#,#,#,#,#,#,#,#,#,#,#,#,#,#,#,#,#,#,#,#,#,#,#,#,#,#,#,#,#,#,#,#,#,#,#,#,#,#,#,#,#,#,#,#,#,#,#,#,#,#,#,#,#,#,#,#,#,#,#,#,.,#
#,.,.,.,#,#,#,#,#,#,Y,#,#,#,#,#,#,#,#,#,#,#,#,#,#,#,#,#,#,Y,#,#,#,#,#,#,#,#,#,Y,#,#,#,#,#,#,#,#,#,#,#,#,#,Y,#,#,#,#,#,#,#,#,#,#,#,#,#,Y,#,#,#,#,#,#,#,#,#,#,#,#,#,#,Y,#,#,#,#,#,#,#,#,#,.,#
#,.,.,.,.,.,.,.,.,.,.,.,.,.,.,.,.,.,.,.,.,.,.,.,.,.,.,.,.,.,.,.,.,.,.,.,.,.,.,.,.,.,.,.,.,.,.,.,.,.,.,.,.,.,.,.,.,.,.,.,.,.,.,.,.,.,.,.,.,.,.,.,.,.,.,.,.,.,.,.,.,.,.,.,.,.,.,.,.,.,.,.,.,#
#,.,.,.,.,.,.,.,.,.,.,.,.,.,.,.,.,.,.,.,.,.,.,.,.,.,.,.,.,.,.,.,.,.,.,.,.,.,.,.,.,.,.,.,.,.,.,.,.,.,.,.,.,.,.,.,.,.,.,.,.,.,.,.,.,.,.,.,.,.,.,.,.,.,.,.,.,.,.,.,.,.,.,.,.,.,.,.,.,.,.,.,.,#
#,.,.,.,.,.,.,.,.,.,.,.,.,.,.,.,.,.,.,.,.,.,.,.,.,.,.,.,.,.,.,.,.,.,.,.,.,.,.,.,.,.,.,.,.,.,.,.,.,.,.,.,.,.,.,.,.,.,.,.,.,.,.,.,.,.,.,.,.,.,.,.,.,.,.,.,.,.,.,.,.,.,.,.,.,.,.,.,.,.,.,.,.,#
#,#,#,#,#,#,#,#,#,#,#,#,#,#,#,#,#,#,#,#,#,#,#,#,#,#,#,#,#,#,#,#,#,#,#,#,#,#,#,#,#,#,#,#,#,#,#,#,#,#,#,#,#,#,#,#,#,#,#,#,#,#,#,#,#,#,#,#,#,#,#,#,#,#,#,#,#,#,#,#,#,#,#,#,#,#,#,#,#,#,#,#,#,#