#,#,#,#,#,#,#,#,#,#,#,#,#,#,#,#,#,#,#,#,#,#,#,#,#,#,#,#,#,#,#,#,#,#,#,#,#,#,#,#,#,#,#,#,#,#,#,#,#,#,#,#,#,#,#,#,#,#,#,#,#,#,#,#,#,#,#,#,#,#,#,#,#,#,#,#,#,#,#,#,#,#,#,#,#,#,#,#,#,#,#,#,#,#,#,#,#,#,#,#,#,#,#,#,#,#,#,#,#,#,#,#,#,#,#,#,#,#,#,#,#,#,#,#,#,#,#,#,#,#,#,#,#,#,#,#,#,#,#,#,#,#,#,#,#,#,#,#,#,#,#,#,#,#,#,#,#,#,#,#,#,#,#,#,#,#,#,#
#,#,#,#,#,#,#,.,.,.,.,.,.,.,.,.,.,.,.,.,.,.,.,.,.,.,.,.,.,.,.,.,.,.,.,.,.,.,.,.,.,.,.,.,.,.,.,.,.,.,.,.,.,.,A2,A2,.,.,.,.,.,.,.,.,.,.,.,.,.,.,.,.,.,.,.,.,.,.,a2,.,a2,.,.,.,.,.,.,.,.,.,.,.,.,.,.,.,.,.,#,#,#,.,.,.,.,.,.,.,.,.,.,.,.,.,.,.,.,.,.,.,.,.,.,.,.,.,.,.,.,.,#,#,#,#,#,#,#,#,#,#,#,#,#,#,#,#,#,.,.,.,.,.,,a10,a10,a10,.,.,.,.,.,.,.,#,#,#,#,#
#,#,#,#,#,#,#,.,.,.,.,.,.,.,.,.,.,.,.,.,.,.,.,.,.,.,.,.,.,.,.,.,.,.,.,.,.,.,.,.,.,.,.,.,.,.,.,.,.,.,.,.,.,.,A2,A2,.,.,.,.,.,.,.,.,.,.,.,.,.,.,.,.,.,.,.,.,.,.,a2,S,a2,.,.,.,.,.,.,.,.,.,.,.,.,.,.,.,.,.,#,#,#,.,.,.,.,.,.,.,.,.,.,W5,.,.,.,.,.,.,.,.,.,.,.,.,.,.,.,.,.,.,.,.,.,.,.,.,.,..,#,#,#,#,#,#,#,#,W10,.,.,.,.,.,,a10,a10,a10,.,.,.,.,.,.,.,#,#,#,#,#
#,#,#,#,#,#,#,.,.,.,.,.,.,.,.,.,.,.,E,.,.,.,.,.,.,.,.,.,.,.,.,.,.,.,.,.,.,.,.,.,.,.,.,.,.,.,.,.,.,.,.,.,.,.,A2,A2,.,.,.,.,.,.,.,.,.,.,.,.,.,.,.,.,.,.,.,.,.,.,a2,a2,a2,.,.,.,.,.,.,.,.,.,.,.,.,.,E,.,.,.,#,#,#,.,.,.,#,#,#,A5,A5,A5,A5,#,a5,a5,a5,a5,a5,a5,#,.,.,.,.,.,.,.,.,.,.,.,.,.,.,.,.,.,.,.,#,#,#,#,#,#,#,#,#,#,.,.,.,.,,a10,a10,a10,.,.,.,.,.,.,.,#,#,#,#,#
#,#,#,#,#,#,#,.,.,.,.,.,.,#,#,#,#,#,#,#,#,#,#,#,.,.,.,.,.,.,.,.,.,.,.,.,.,.,.,.,.,.,.,.,.,.,.,.,.,.,.,.,.,.,A2,A2,.,.,.,A2,A2,A2,A2,A2,A2,A2,A2,A2,A2,A2,A2,A2,A2,A2,A2,A2,A2,A2,A2,A2,A2,#,#,#,#,#,#,#,#,#,#,#,#,#,#,.,.,.,#,#,#,.,.,.,.,.,#,.,.,.,.,.,.,.,.,.,#,#,#,.,.,.,.,.,#,A8,A8,A8,A8,#,.,.,.,.,.,.,.,.,#,#,#,#,#,#,#,#,.,.,.,.,.,.,,a10,a10,a10,.,.,.,.,.,.,.,#,#,#,#,#
#,#,#,#,#,#,#,E,.,.,.,.,.,#,#,#,#,#,#,#,#,#,#,#,.,.,.,.,.,.,.,.,.,.,.,.,.,.,.,.,.,.,.,.,.,.,.,.,.,.,.,.,.,.,A2,A2,.,.,.,A2,A2,A2,A2,A2,A2,A2,A2,A2,A2,A2,A2,A2,A2,A2,A2,A2,A2,A2,A2,A2,A2,#,#,#,#,#,#,#,#,#,#,#,#,#,#,.,.,.,#,#,#,#,#,.,.,.,#,.,.,.,.,.,.,.,.,.,#,#,.,.,.,.,.,#,#,.,.,.,.,#,#,#,a8,a8,a8,a8,a8,a8,#,#,#,#,#,#,#,#,Y,,,.,.,.,,a10,a10,a10,.,.,.,.,.,.,.,.,.,.,#,#
#,#,#,#,#,#,#,#,#,#,.,.,.,.,.,.,.,.,.,.,.,.,#,#,.,.,.,.,.,.,.,.,.,.,.,.,.,.,.,.,.,.,.,.,.,.,.,.,.,.,.,.,.,.,A2,A2,.,.,.,.,.,.,.,.,.,.,.,.,.,.,.,.,.,.,.,.,.,.,.,.,.,#,#,#,#,#,#,#,#,#,#,#,#,#,#,.,.,.,#,#,#,.,.,.,.,.,#,.,.,.,.,.,.,.,.,.,#,#,.,.,.,.,#,#,#,.,.,.,.,#,#,#,.,.,.,.,.,.,#,#,#,#,#,#,#,#,#,#,#,.,.,.,,a10,a10,a10,.,.,.,.,.,.,.,.,.,.,#,#
#,#,#,#,#,#,#,#,#,#,#,#,.,.,.,.,.,.,.,.,.,.,#,#,#,#,#,.,.,.,.,.,.,.,.,.,.,.,.,.,.,.,.,.,.,.,.,.,.,.,.,.,.,.,A2,A2,.,.,.,.,.,.,.,.,.,.,.,.,.,.,.,.,.,.,.,.,.,.,.,.,.,#,#,#,#,#,#,#,#,#,.,.,.,.,.,.,.,.,#,#,#,.,.,,#,#,#,.,.,.,.,.,.,.,.,.,#,#,W8,.,.,#,#,#,#,.,.,.,.,#,#,#,.,.,.,.,.,.,#,#,#,#,#,#,.,.,.,.,.,.,.,.,,a10,a10,a10,.,.,.,.,.,.,.,.,.,.,#,#
#,#,#,#,#,#,#,.,.,.,#,#,#,#,.,.,.,.,.,.,.,.,#,#,#,#,#,.,.,.,.,.,.,.,.,.,.,.,.,.,.,.,.,.,.,.,.,.,.,.,.,.,.,.,A2,A2,.,.,.,.,.,.,.,.,.,.,.,.,.,.,.,.,.,.,.,.,.,.,.,.,.,.,#,#,#,#,#,#,#,#,.,.,.,.,.,.,.,.,#,#,#,W5,.,.,.,.,.,.,.,.,.,.,.,.,.,.,#,#,#,.,#,#,#,#,#,.,.,.,.,#,#,#,.,.,.,.,.,.,#,#,#,#,#,#,.,.,.,.,.,.,.,.,,a10,a10,a10,.,.,.,.,.,.,.,.,.,S,#,#
#,#,#,#,#,#,#,.,.,.,.,.,#,#,#,#,.,.,.,.,.,.,#,#,#,#,#,.,.,.,.,.,.,.,.,.,.,.,.,.,.,.,.,.,.,.,.,.,.,.,.,.,.,.,A2,A2,A2,A2,A2,A2,A2,A2,A2,A2,A2,A2,A2,A2,A2,.,.,.,.,.,.,.,.,.,.,.,.,T,#,#,#,#,#,#,#,#,.,.,.,.,.,.,E,.,#,#,#,#,#,,.,.,.,.,.,.,.,.,.,.,.,.,#,#,.,.,#,#,#,#,#,.,.,.,.,#,#,#,#,#,#,#,.,.,#,#,#,#,#,#,.,.,.,.,.,.,.,#,#,#,#,#,#,.,.,.,.,.,.,.,.,#,#,#
#,#,#,#,#,#,.,.,.,.,.,.,#,#,#,#,.,.,.,.,.,.,#,#,#,#,#,.,.,.,.,.,.,.,.,.,.,.,.,.,.,.,.,.,.,.,.,.,.,.,.,.,.,.,A2,A2,A2,A2,A2,A2,A2,A2,A2,A2,A2,A2,A2,A2,A2,.,.,.,.,.,.,.,.,.,.,.,.,#,#,#,#,#,#,#,#,#,.,.,.,#,#,#,#,#,#,#,#,.,.,.,.,.,#,#,#,#,#,#,#,#,.,.,#,#,.,.,#,#,#,#,#,.,.,.,.,#,#,#,#,#,#,#,.,.,#,#,#,#,#,#,.,.,.,.,.,.,.,.,.,#,#,#,#,.,.,.,.,.,.,.,.,.,D1,#
#,#,#,#,#,#,T,.,.,.,.,.,.,.,.,.,.,.,.,.,.,.,#,#,#,#,#,.,.,E,.,.,E,.,.,E,.,.,E,.,.,E,.,.,E,.,.,.,.,.,.,.,.,.,.,.,.,.,.,.,.,.,.,.,.,.,.,.,.,.,.,.,A2,A2,A2,.,.,.,.,.,.,#,#,#,#,#,#,#,#,#,.,.,.,#,#,#,#,#,#,#,#,T,.,.,E,.,#,#,#,#,#,#,#,#,.,.,#,#,.,.,#,#,#,#,#,.,.,.,.,#,#,#,#,#,#,#,.,.,#,#,#,#,#,#,T,.,.,.,.,.,.,.,.,#,#,#,#,E,.,.,.,.,#,.,.,.,D1,#
#,#,#,#,#,#,#,.,.,.,.,.,.,.,.,.,.,.,.,.,.,E,#,#,#,#,#,#,#,#,#,#,#,#,#,#,#,#,#,#,#,#,#,#,#,#,#,.,.,.,.,.,.,.,.,.,.,.,.,.,.,.,.,.,.,.,.,.,.,.,.,.,A2,A2,A2,.,.,.,.,.,.,#,#,#,#,#,#,#,#,#,.,.,.,#,#,#,#,#,#,#,#,#,#,#,#,#,#,.,.,.,.,.,.,.,.,.,#,#,.,.,#,#,#,#,#,.,.,.,.,#,#,#,.,.,.,.,.,.,#,#,#,#,#,#,#,#,#,#,#,A9,.,.,.,#,#,#,#,#,#,.,.,.,#,#,#,#,#,#
#,#,#,#,#,#,#,.,.,.,.,.,.,A1,A1,A1,#,#,#,#,#,#,#,#,#,#,#,#,#,#,#,#,#,#,#,#,#,#,#,#,#,#,#,#,#,#,#,.,.,.,.,.,.,.,.,.,.,.,.,.,.,.,.,.,.,.,.,.,.,.,.,.,.,.,.,.,.,.,.,.,.,.,#,#,#,#,#,#,#,.,.,.,.,#,#,#,#,#,#,#,#,#,#,#,#,#,.,.,.,.,.,,,,T,.,#,#,.,.,#,#,#,#,#,.,.,.,.,#,#,#,.,.,E,.,.,.,#,#,#,#,#,#,#,#,#,#,#,.,.,.,.,#,#,#,#,#,.,.,.,.,.,#,#,#,#,#
#,#,#,#,#,#,#,.,.,.,.,.,.,A1,A1,A1,#,#,#,#,#,#,#,#,#,#,#,#,#,#,#,#,#,#,#,#,#,#,#,#,#,#,#,#,#,#,#,#,#,.,.,.,.,.,.,.,.,.,.,.,.,.,.,.,.,.,.,A2,A2,A2,.,.,.,.,.,.,.,.,.,.,.,T,#,#,#,#,#,#,#,T,.,.,.,.,.,.,.,.,.,.,.,#,#,#,#,#,.,.,.,.,.,#,#,#,#,#,#,#,.,.,#,#,#,#,#,.,.,.,.,.,#,#,.,.,#,#,#,#,#,#,#,#,#,#,.,.,#,#,#,.,.,.,A9,#,#,#,#,#,.,.,.,.,.,#,#,#,#,#
#,#,#,#,#,#,#,.,.,.,.,.,.,.,.,.,.,.,.,.,.,.,#,#,#,#,#,#,#,#,#,#,#,#,#,#,#,#,#,#,#,#,#,#,#,#,#,#,#,.,.,.,.,.,.,.,.,.,.,.,.,.,.,.,.,.,.,A2,A2,A2,.,.,.,.,.,.,.,.,.,.,.,#,#,#,#,#,#,#,#,#,.,.,.,.,.,.,.,.,.,.,.,#,#,#,#,#,.,.,.,E,.,#,.,.,.,.,#,#,.,.,#,#,#,#,#,.,.,.,.,.,#,#,.,.,#,#,#,#,#,#,#,#,#,W9,.,.,#,#,#,.,.,.,.,#,#,#,#,#,.,.,.,.,.,#,#,#,#,#
#,#,#,#,#,#,#,.,.,.,.,.,.,.,.,.,.,.,.,.,.,.,#,#,#,#,#,#,#,#,#,#,#,#,#,#,#,#,#,#,#,#,#,#,#,#,#,#,#,#,#,.,.,.,.,.,.,.,.,.,.,.,.,.,.,.,.,.,.,.,.,.,.,.,.,.,.,.,.,.,.,#,#,#,#,#,#,#,#,#,.,.,.,.,.,E,.,.,.,.,.,#,#,#,#,#,.,.,.,#,#,#,.,.,.,.,#,#,.,.,#,#,#,#,#,.,.,.,.,#,#,#,.,.,#,#,#,#,#,#,#,#,#,#,.,.,#,#,#,.,.,.,.,#,#,#,#,#,.,.,.,.,.,#,#,#,#,#
#,#,#,#,#,#,#,.,.,.,E,.,.,.,.,.,.,.,.,.,.,.,#,#,#,#,#,#,#,#,#,#,#,#,#,#,#,#,#,#,#,#,#,#,#,#,#,#,#,#,#,.,.,.,.,.,.,.,.,.,.,.,.,.,.,.,.,.,.,.,.,.,.,.,.,.,.,.,.,.,.,#,#,#,#,#,#,#,#,#,#,#,#,#,#,#,#,.,.,.,.,#,#,#,#,W3,.,.,.,.,.,.,.,.,.,.,#,#,.,.,#,#,#,#,#,.,.,.,.,#,#,#,.,.,#,#,#,#,#,#,#,#,#,.,.,.,#,#,#,A9,.,.,.,#,#,#,#,#,.,.,.,.,.,#,#,#,#,#
#,#,#,#,#,#,W1,.,.,.,.,.,.,.,#,#,.,.,.,.,.,.,#,#,#,#,#,#,#,#,#,#,#,#,#,#,#,#,#,#,#,#,#,#,#,#,#,#,#,#,#,#,#,.,.,.,.,.,.,.,.,.,.,.,.,.,.,.,.,.,.,.,.,.,.,.,.,.,.,.,.,#,#,#,#,#,#,#,#,#,#,#,#,#,#,#,#,.,.,.,.,#,#,#,#,#,A4,.,.,.,.,.,.,.,.,W4,#,#,.,.,#,#,#,#,#,.,.,.,.,#,#,#,.,.,.,.,.,.,#,#,#,#,#,.,.,#,#,#,#,.,.,.,.,#,#,#,#,#,.,.,.,.,.,#,#,#,#,#
#,#,#,#,#,#,#,#,#,#,#,#,#,#,#,#,#,#,.,.,.,.,#,#,#,#,#,#,#,#,#,#,#,#,#,#,#,#,#,#,#,#,#,#,#,#,#,#,#,#,#,#,#,.,.,.,.,.,.,.,.,.,.,.,.,.,.,.,.,A2,A2,A2,.,.,.,.,.,.,.,.,.,#,#,#,#,#,#,#,#,#,#,#,#,#,#,#,#,.,.,.,.,#,#,#,#,#,.,.,.,.,.,.,.,.,.,#,#,#,.,.,#,#,.,.,.,.,.,.,.,#,#,#,.,.,E,.,.,.,#,#,#,#,#,.,.,.,#,#,#,.,.,.,.,#,#,#,#,#,.,.,.,.,.,#,#,#,#,#
#,#,#,#,#,#,#,#,#,#,#,#,#,#,#,#,#,#,.,.,.,.,#,#,#,#,#,#,#,#,#,#,#,#,#,#,#,#,#,#,#,#,#,#,#,#,#,#,#,#,#,#,#,#,#,.,.,.,.,.,.,.,.,.,.,.,.,.,.,A2,A2,A2,.,.,.,.,.,.,.,.,.,#,#,#,#,#,#,#,#,#,.,.,.,.,.,.,.,.,.,.,.,#,#,#,#,#,.,.,.,A4,A4,A4,#,.,.,.,#,#,.,.,#,#,.,.,.,.,.,.,.,#,#,#,#,#,#,.,.,.,#,#,#,#,#,#,.,.,#,#,#,.,.,.,A9,#,#,#,#,#,.,.,.,.,.,#,#,#,#,#
#,#,#,#,#,#,#,#,#,#,#,#,#,#,#,#,.,.,.,.,.,.,#,#,#,#,#,#,#,#,#,#,#,#,#,#,#,#,#,#,#,#,#,#,#,#,#,#,#,#,#,#,#,#,#,.,.,.,.,.,.,.,.,.,.,.,.,.,.,.,.,.,.,,.,.,.,.,.,.,.,#,#,#,#,#,#,#,#,#,.,.,.,.,.,.,.,.,.,.,.,#,#,#,.,.,.,.,.,.,.,.,.,.,.,.,#,#,.,.,#,#,.,#,#,.,.,.,.,#,#,#,#,#,#,.,.,.,#,#,#,#,#,.,.,.,#,#,#,.,.,.,.,#,#,#,#,#,.,.,.,.,.,#,#,#,#,#
#,#,#,#,#,#,#,#,#,#,#,#,#,.,.,.,.,.,.,.,.,.,#,#,#,#,#,#,#,#,#,#,#,#,#,#,#,#,#,#,#,#,#,#,#,#,#,#,#,#,#,#,#,#,#,#,#,.,.,.,.,.,.,.,.,.,.,.,.,.,.,.,.,A2,A2,A2,.,.,.,.,.,#,#,#,#,#,#,#,#,#,.,.,.,.,.,.,.,.,.,E,.,#,#,#,.,.,.,.,.,.,.,.,.,.,A3,A3,#,#,.,.,#,#,.,#,#,.,.,.,.,#,#,#,#,#,#,.,.,.,#,#,#,#,#,.,.,#,#,#,#,.,.,.,.,#,#,#,#,#,.,.,.,.,.,#,#,#,#,#
#,W1,.,.,.,.,.,.,.,#,#,#,#,.,.,.,.,.,.,.,.,.,#,#,#,#,#,#,#,#,#,#,#,#,#,#,#,#,#,#,#,#,#,#,#,#,#,#,#,#,#,#,#,#,#,#,#,.,.,.,.,.,.,.,.,.,.,.,.,.,.,.,.,A2,A2,A2,.,.,.,.,.,#,#,#,#,#,#,#,#,#,.,.,#,#,#,#,#,#,#,#,#,#,#,#,#,#,#,#,#,#,.,.,,A3,A3,.,.,.,.,.,#,#,.,#,#,.,.,.,.,#,#,#,.,.,.,.,.,.,#,#,#,#,#,.,.,.,#,#,#,A9,.,.,.,#,#,#,#,#,.,.,.,.,.,#,#,#,#,#
#,#,.,.,.,.,.,.,.,.,#,#,#,.,.,.,.,.,.,#,#,#,#,#,#,#,#,#,#,#,#,#,#,#,#,#,#,#,#,#,#,#,#,#,#,#,#,#,#,#,#,#,#,#,#,#,#,#,#,.,.,.,.,.,.,.,.,.,.,.,.,.,.,.,.,.,.,.,A2,A2,A2,#,#,#,#,#,#,#,#,#,.,.,#,#,#,#,#,#,#,#,#,#,#,#,#,#,#,#,#,#,.,.,A3,A3,.,.,.,.,.,.,#,#,.,#,#,.,.,.,.,#,#,#,.,.,.,.,.,.,#,#,#,#,#,.,.,.,#,#,#,.,.,.,.,#,#,#,#,#,.,.,.,.,.,#,#,#,#,#
#,#,.,.,.,.,.,.,.,.,.,a1,a1,.,.,.,.,.,.,#,#,#,#,#,#,#,#,#,#,#,#,#,#,#,#,#,#,#,#,#,#,#,#,#,#,#,#,#,#,#,#,#,#,#,#,#,#,#,#,.,.,.,.,.,.,.,.,.,.,.,.,.,.,.,.,.,.,.,A2,A2,A2,#,#,#,#,#,#,#,#,#,.,.,#,#,#,#,#,#,#,#,#,#,#,#,.,.,a3,.,.,.,.,.,A3,.,.,.,.,.,.,.,a6,a6,.,#,#,.,.,.,.,#,#,#,.,#,#,#,#,#,#,#,#,#,#,.,.,.,.,.,.,.,.,.,.,#,#,#,#,#,.,.,.,.,.,#,#,#,#,#
#,#,.,.,.,.,P,.,.,.,.,a1,a1,.,.,.,.,.,.,.,.,.,#,#,#,#,#,#,#,#,#,#,#,#,#,#,#,#,#,#,#,#,#,#,#,#,#,#,#,#,#,#,#,#,#,#,#,#,#,#,#,.,.,.,.,.,.,.,.,.,.,.,.,.,.,.,.,.,.,.,.,#,#,#,#,#,#,#,#,#,.,.,.,.,.,.,.,.,.,.,.,.,.,.,.,.,a3,.,.,.,.,A3,A3,.,.,.,.,.,.,.,a6,a6,.,#,#,.,.,.,.,#,#,#,.,#,#,#,#,#,#,#,#,#,#,#,.,.,.,.,.,.,.,.,A9,#,#,#,#,#,.,.,.,.,.,#,#,#,#,#
#,#,.,.,.,.,Z,.,.,.,.,a1,a1,.,.,.,.,.,.,.,.,.,#,#,#,#,#,#,#,#,#,#,#,#,#,#,#,#,#,#,#,#,#,#,#,#,#,#,#,#,#,#,#,#,#,#,#,#,#,#,#,.,.,.,.,.,.,.,.,.,.,.,.,.,.,.,.,.,.,.,.,#,#,#,#,#,#,.,.,.,.,.,.,.,.,.,.,.,.,.,.,.,.,.,.,.,a3,.,.,E,.,A3,A6,A6,A6,A6,A6,A6,A6,A6,#,#,.,a6,#,.,.,.,.,#,#,#,.,.,.,.,.,.,.,.,.,.,.,.,.,.,.,.,.,.,.,.,.,#,#,#,#,#,.,.,.,.,.,#,#,#,#,#
#,#,.,.,.,.,.,.,.,.,.,a1,a1,.,.,.,.,.,.,E,.,.,#,#,#,#,#,#,#,#,#,#,#,#,#,#,#,#,#,#,#,#,#,#,#,#,#,#,#,#,#,#,#,#,#,#,#,#,#,#,#,#,#,.,.,.,.,.,E,.,.,.,.,.,.,.,E,.,.,.,.,W2,#,#,#,#,W3,.,.,.,.,.,.,.,.,.,.,$,.,.,.,E,.,.,E,.,a3,.,#,#,#,#,Y,Y,Y,Y,Y,Y,Y,Y,#,#,.,a6,#,Y,Y,Y,Y,#,#,#,.,.,.,.,E,.,.,.,.,.,.,T,.,.,.,.,.,.,.,.,.,#,#,#,#,#,Y,Y,Y,Y,Y,#,#,#,#,#
#,#,#,#,#,#,#,#,#,#,#,#,#,#,#,#,#,#,#,#,#,#,#,#,#,#,#,#,#,#,#,#,#,#,#,#,#,#,#,#,#,#,#,#,#,#,#,#,#,#,#,#,#,#,#,#,#,#,#,#,#,#,#,#,#,#,#,#,#,#,#,#,#,#,#,#,#,#,#,#,#,#,#,#,#,#,#,#,#,#,#,#,#,#,#,#,#,#,#,#,#,#,#,#,#,#,#,#,#,#,#,#,#,#,#,#,#,#,#,#,#,#,.,#,#,#,#,#,#,#,#,#,#,#,#,#,#,#,#,#,#,#,#,#,#,#,#,#,#,#,#,#,#,#,#,#,#,#,#,#,#,#,#,#,#,#,#,#
#,#,#,#,#,#,#,#,#,#,#,#,#,#,#,#,#,#,#,#,#,#,#,#,#,#,#,#,#,#,#,#,#,#,#,#,#,#,#,#,#,#,#,#,#,#,#,#,#,#,#,#,#,#,#,#,#,#,#,#,#,#,#,#,#,#,#,#,#,#,#,#,#,#,#,#,#,#,#,#,#,#,#,#,#,#,#,#,#,#,#,#,#,#,#,#,#,#,#,#,#,#,#,#,#,#,#,#,#,#,#,#,#,#,#,#,#,#,#,#,#,a6,.,#,#,#,#,#,#,#,#,#,#,#,#,#,#,#,#,#,#,#,#,#,#,#,#,#,#,#,#,#,#,#,#,#,#,#,#,#,#,#,#,#,#,#,#,#
#,#,#,#,#,#,#,#,#,#,#,#,#,#,#,#,#,#,#,#,#,#,#,#,#,#,#,#,#,#,#,#,#,#,#,#,#,#,#,#,#,#,#,#,#,#,#,#,#,#,#,#,#,#,#,#,#,#,#,#,#,#,#,#,#,#,#,#,#,#,#,#,#,#,#,#,#,#,#,#,#,#,#,#,#,#,#,#,#,#,#,#,#,#,#,#,#,#,#,#,#,#,#,#,#,#,#,#,#,#,#,#,#,#,#,#,#,#,#,#,#,a6,.,#,#,#,#,#,#,#,#,#,#,#,#,#,#,#,#,#,#,#,#,#,#,#,#,#,#,#,#,#,#,#,#,#,#,#,#,#,#,#,#,#,#,#,#,#
#,#,#,#,#,#,#,#,#,#,#,#,#,#,#,#,#,#,#,#,#,#,#,#,#,#,#,#,#,#,#,#,#,#,#,#,#,#,#,#,#,#,#,#,#,#,#,#,#,#,#,#,#,#,#,#,#,#,#,#,#,#,#,#,#,#,#,#,#,#,#,#,#,#,#,#,#,#,#,#,#,#,#,#,#,#,#,#,#,#,#,#,#,#,#,#,#,#,#,#,#,#,#,#,#,#,#,#,#,#,#,#,#,#,#,#,#,#,#,#,#,#,.,#,#,#,#,#,#,#,#,#,#,#,#,#,#,#,#,#,#,#,#,#,#,#,#,#,#,#,#,#,#,#,#,#,#,#,#,#,#,#,#,#,#,#,#,#
#,#,#,#,#,#,#,#,#,#,#,#,#,#,#,#,#,#,#,#,#,#,#,#,#,#,#,#,#,#,#,#,#,#,#,#,#,#,#,#,#,#,#,#,#,#,#,#,#,#,#,#,#,#,#,#,#,#,#,#,#,#,#,#,#,#,#,#,#,#,#,#,#,#,#,#,#,#,#,#,#,#,#,#,#,#,#,#,#,#,#,#,#,#,#,#,#,#,#,#,#,#,#,#,#,#,#,#,#,#,#,#,#,#,#,#,#,#,#,#,#,#,.,a6,#,#,#,#,#,#,#,#,#,#,#,#,#,#,#,#,#,#,#,#,#,#,#,#,#,#,#,#,#,#,#,#,#,#,#,#,#,#,#,#,#,#,#,#
#,#,#,#,#,#,#,#,#,#,#,#,#,#,#,#,#,#,#,#,#,#,#,#,#,#,#,#,#,#,#,#,#,#,#,#,#,#,#,#,#,#,#,#,#,#,#,#,#,#,#,#,#,#,#,#,#,#,#,#,#,#,#,#,#,#,#,#,#,#,#,#,#,#,#,#,#,#,#,#,#,#,#,#,#,#,#,#,#,#,#,#,#,#,#,#,#,#,#,#,#,#,#,#,#,#,#,#,#,#,#,#,#,#,#,#,#,#,#,#,#,#,.,a6,#,#,#,#,#,#,#,#,#,#,#,#,#,#,#,#,#,#,#,#,#,#,#,#,#,#,#,#,#,#,#,#,#,#,#,#,#,#,#,#,#,#,#,#
#,#,#,#,#,#,#,#,#,#,#,#,#,#,#,#,#,#,#,#,#,#,#,#,#,#,#,#,#,#,#,#,#,#,#,#,#,#,#,#,#,#,#,#,#,#,#,#,#,#,#,#,#,#,#,#,#,#,#,#,#,#,#,#,#,#,#,#,#,#,#,#,#,#,#,#,#,#,#,#,#,#,#,#,#,#,#,#,#,#,#,#,#,#,#,#,#,#,#,#,#,#,#,#,#,#,#,#,#,#,#,#,#,#,#,#,#,#,#,#,#,#,.,#,#,#,#,#,#,#,#,#,#,#,#,#,#,#,#,#,#,#,#,#,#,#,#,#,#,#,#,#,#,#,#,#,#,#,#,#,#,#,#,#,#,#,#,#
,,,,,,,,,,,,,,,,,,,,,,,,,,,,,,,,,,,,,,,,,,,,,,,,,,,,,,,,,,,,,,,,,,,,,,,,,,,,,,,,,,,,,,,,,,,,,,,,,,,,,,,,,,,,,,,,,,,,,,#,#,#,a6,.,#,#,#,#,,,,,,,,,,,,,,,,,,,,,,,,,,,,,,,,,,,,,,,,,
,,,,,,,,,,,,,,,,,,,,,,,,,,,,,,,,,,,,,,,,,,,,,,,,,,,,,,,,,,,,,,,,,,,,,,,,,,,,,,,,,,,,,,,,,,,,,,,,,,,,,,,,,,,,,,,,,,,,,,#,#,#,a6,.,#,#,#,#,,,,,,,,,,,,,,,,,,,,,,,,,,,,,,,,,,,,,,,,,
,,,,,,,,,,,,,,,,,,,,,,,,,,,,,,,,,,,,,,,,,,,,,,,,,,,,,,,,,,,,,,,,,,,,,,,,,,,,,,,,,,,,,,,,,,,,,,,,,,,,,,,,,,,,,,,,,,,,,,#,#,#,#,.,#,#,#,#,,,,,,,,,,,,,,,,,,,,,,,,,,,,,,,,,,,,,,,,,
,,,,,,,,,,,,,,,,,,,,,,,,,,,,,,,,,,,,,,,,,,,,,,,,,,,,,,,,,,,,,,,,,,,,,,,,,,,,,,,,,,,,,,,,,,,,,,,,,,,,,,,,,,,,,,,,,,,,,,#,#,#,#,.,a6,#,#,#,,,,,,,,,,,,,,,,,,,,,,,,,,,,,,,,,,,,,,,,,
,,,,,,,,,,,,,,,,,,,,,,,,,,,,,,,,,,,,,,,,,,,,,,,,,,,,,,,,,,,,,,,,,,,,,,,,,,,,,,,,,,,,,,,,,,,,,,,,,,,,,,,,,,,,,,,,,,,,,,#,#,#,#,.,a6,#,#,#,,,,,,,,,,,,,,,,,,,,,,,,,,,,,,,,,,,,,,,,,
,,,,,,,,,,,,,,,,,,,,,,,,,,,,,,,,,,,,,,,,,,,,,,,,,,,,,,,,,,,,,,,,,,,,,,,,,,,,,,,,,,,,,,,,,,,,,,,,,,,,,,,,,,,,,,,,,,,,,,#,#,#,#,.,#,#,#,#,,,,,,,,,,,,,,,,,,,,,,,,,,,,,,,,,,,,,,,,,
,,,,,,,,,,,,,,,,,,,,,,,,,,,,,,,,,,,,,,,,,,,,,,,,,,,,,,,,,,,,,,,,,,,,,,,,,,,,,,,,,,,,,,,,,,,,,,,,,,,,,,,,,,,,,,,,,,,,,,#,#,#,#,.,#,#,#,#,,,,,,,,,,,,,,,,,,,,,,,,,,,,,,,,,,,,,,,,,
,,,,,,,,,,,,,,,,,,,,,,,,,,,,,,,,,,,,,,,,,,,,,,,,,,,,,,,,,,,,,,,,,,,,,,,,,,,,,,,,,,,,,,,,,,,,,,,,,,,,,,,,,,,,,,,,,,,,,,#,#,a6,a6,.,#,#,#,#,,,,,,,,,,,,,,,,,,,,,,,,,,,,,,,,,,,,,,,,,
,,,,,,,,,,,,,,,,,,,,,,,,,,,,,,,,,,,,,,,,,,,,,,,,,,,,,,,,,,,,,,,,,,,,,,,,,,,,,,,,,,,,,,,,,,,,,,,,,,,,,,,,,,,,,,,,,,,,,,#,#,a6,a6,.,#,#,#,#,,,,,,,,,,,,,,,,,,,,,,,,,,,,,,,,,,,,,,,,,
,,,,,,,,,,,,,,,,,,,,,,,,,,,,,,,,,,,,,,,,,,,,,,,,,,,,,,,,,,,,,,,,,,,,,,,,,,,,,,,,,,,,,,,,,,,,,,,,,,,,,,,,,,,,,,,,,,,,,,#,#,a6,a6,.,a6,#,#,#,,,,,,,,,,,,,,,,,,,,,,,,,,,,,,,,,,,,,,,,,
,,,,,,,,,,,,,,,,,,,,,,,,,,,,,,,,,,,,,,,,,,,,,,,,,,,,,,,,,,,,,,,,,,,,,,,,,,,,,,,,,,,,,,,,,,,,,,,,,,,,,,,,,,,,,,,,,,,,,,#,#,#,#,.,a6,#,#,#,,,,,,,,,,,,,,,,,,,,,,,,,,,,,,,,,,,,,,,,,
,,,,,,,,,,,,,,,,,,,,,,,,,,,,,,,,,,,,,,,,,,,,,,,,,,,,,,,,,,,,,,,,,,,,,,,,,,,,,,,,,,,,,,,,,,,,,,,,,,,,,,,,,,,,,,,,,,,,,,#,#,#,#,.,.,#,#,#,,,,,,,,,,,,,,,,,,,,,,,,,,,,,,,,,,,,,,,,,
,,,,,,,,,,,,,,,,,,,,,,,,,,,,,,,,,,,,,,,,,,,,,,,,,,,,,,,,,,,,,,,,,,,,,,,,,,,,,,,,,,,,,,,,,,,,,,,,,,,,,,,,,,,,,,,,,,,,,,#,#,#,#,.,.,.,.,#,,,,,,,,,,,,,,,,,,,,,,,,,,,,,,,,,,,,,,,,,
,,,,,,,,,,,,,,,,,,,,,,,,,,,,,,,,,,,,,,,,,,,,,,,,,,,,,,,,,,,,,,,,,,,,,,,,,,,,,,,,,,,,,,,,,,,,,,,,,,,,,,,,,,,,,,,,,,,,,,#,#,#,#,.,.,+,W6,#,,,,,,,,,,,,,,,,,,,,,,,,,,,,,,,,,,,,,,,,,
,,,,,,,,,,,,,,,,,,,,,,,,,,,,,,,,,,,,,,,,,,,,,,,,,,,,,,,,,,,,,,,,,,,,,,,,,,,,,,,,,,,,,,,,,,,,,,,,,,,,,,,,,,,,,,,,,,,,,,#,#,#,#,#,#,#,#,#,,,,,,,,,,,,,,,,,,,,,,,,,,,,,,,,,,,,,,,,,
,,,,,,,,,,,,,,,,,,,,,,,,,,,,,,,,,,,,,,,,,,,,,,,,,,,,,,,,,,,,,,,,,,,,,,,,,,,,,,,,,,,,,,,,,,,,,,,,,,,,,,,,,,,,,,,,,,,,,,#,#,#,#,#,#,#,#,#,,,,,,,,,,,,,,,,,,,,,,,,,,,,,,,,,,,,,,,,,